{
	"map_size": {
		"width": 13,
		"height": 11  
	},

	"tiles_ids_table": {
		"#0": 3,
		"#1": 0,
		"#2": 2,
		"#3": 1
	},

	"tiles_size": {
		"width": 32,
		"height": 32
	},

	"tile_map": [[1, 1, 1, 1, 1, 1, 1, 1, 1, 1, 1, 1, 1],
				 [1, 0, 0, 0, 0, 0, 2, 0, 0, 0, 0, 0, 1],
				 [1, 0, 0, 0, 0, 0, 2, 0, 0, 0, 0, 0, 1],
				 [1, 0, 0, 1, 1, 1, 2, 1, 1, 1, 0, 0, 1],
				 [1, 0, 0, 1, 0, 2, 2, 2, 0, 1, 0, 0, 1],
				 [1, 0, 0, 1, 0, 2, 2, 2, 0, 1, 0, 0, 1],
				 [1, 0, 0, 1, 0, 2, 2, 2, 0, 1, 0, 0, 1],
				 [1, 0, 0, 1, 1, 1, 2, 1, 1, 1, 0, 0, 1],
				 [1, 0, 0, 0, 0, 0, 2, 0, 0, 0, 0, 0, 1],
				 [1, 0, 0, 0, 0, 0, 2, 0, 0, 0, 0, 0, 1],
				 [1, 1, 1, 1, 1, 1, 1, 1, 1, 1, 1, 1, 1]],


	"colision_map": [[1, 1, 1, 1, 1, 1, 1, 1, 1, 1, 1, 1, 1],
					 [1, 0, 0, 0, 0, 0, 0, 0, 0, 0, 0, 0, 1],
					 [1, 0, 0, 0, 0, 0, 0, 0, 0, 0, 0, 0, 1],
					 [1, 0, 0, 1, 1, 1, 0, 1, 1, 1, 0, 0, 1],
					 [1, 0, 0, 1, 0, 0, 0, 0, 0, 1, 0, 0, 1],
					 [1, 0, 0, 1, 0, 0, 0, 0, 0, 1, 0, 0, 1],
					 [1, 0, 0, 1, 0, 0, 0, 0, 0, 1, 0, 0, 1],
					 [1, 0, 0, 1, 1, 1, 0, 1, 1, 1, 0, 0, 1],
					 [1, 0, 0, 0, 0, 0, 0, 0, 0, 0, 0, 0, 1],
					 [1, 0, 0, 0, 0, 0, 0, 0, 0, 0, 0, 0, 1],
					 [1, 1, 1, 1, 1, 1, 1, 1, 1, 1, 1, 1, 1]],

	"entitys_pos": {
		"#0": [[0, 0]],
		"#1": [[10, 10], [35, 35]]
	}
}